[
    [
        [1,1,1,1,1,1,1,1],
        [1,0,0,1,1,1,1,1],
        [1,0,0,1,1,1,1,1],
        [1,0,0,0,0,0,0,1],
        [1,1,2,4,1,0,0,1],
        [1,0,0,8,1,0,0,1],
        [1,0,0,0,1,1,1,1],
        [1,1,1,1,1,1,1,1]
    ],
    [
        [1,1,1,1,1,1,1,1],
        [1,0,0,1,1,1,1,1],
        [1,0,0,1,1,1,1,1],
        [1,0,0,0,0,0,0,1],
        [1,1,2,4,1,8,0,1],
        [1,0,0,0,1,0,0,1],
        [1,0,0,0,1,1,1,1],
        [1,1,1,1,1,1,1,1]
    ],
    [
        [1,1,1,1,1,1,1,1,1],
        [1,0,0,0,1,1,1,1,1],
        [1,0,8,0,1,1,1,1,1],
        [1,0,8,0,1,1,1,4,1],
        [1,1,1,0,1,1,1,4,1],
        [1,1,1,0,0,0,0,4,1],
        [1,1,0,2,8,1,0,0,1],
        [1,1,0,0,0,1,1,1,1],
        [1,1,1,1,1,1,1,1,1]
    ],
    [
        [1,1,1,1,1,1,1,1,1,1],
        [1,1,1,0,0,0,0,0,1,1],
        [1,1,1,0,8,0,2,0,1,1],
        [1,1,1,1,1,0,1,0,1,1],
        [1,0,8,0,0,0,0,0,1,1],
        [1,0,0,1,8,1,1,0,1,1],
        [1,4,4,8,0,0,1,0,0,1],
        [1,4,4,0,0,0,0,0,0,1],
        [1,1,1,1,1,1,1,1,1,1]
    ],
    [
        [1,1,1,1,1,1,1,1],
        [1,4,0,0,0,8,0,1],
        [1,4,8,0,0,1,0,1],
        [1,4,1,0,1,0,0,1],
        [1,1,1,0,1,0,1,1],
        [1,1,0,8,0,0,1,1],
        [1,1,2,0,1,1,1,1],
        [1,1,1,1,1,1,1,1]
    ]
]